key	name	output	type
a	and	and{Space}	longpress
b	in	in{Space}	longpress
c	class	class{Space}():{Enter}def{Space}__init__(self):{Up}{Home}{Ctrl down}{Right}{Ctrl up}{Right}	longpress
d	def	def{Space}():{Home}{Ctrl down}{Right}{Ctrl up}{Right}	longpress
e	else	else	longpress
f	for	for{Space}	longpress
g	get	get(	longpress
h	html	html	longpress
i	if	if{Space}	longpress
j	join	join	longpress
k	key	key	longpress
l	len	len(	longpress
m	is	is{Space}	longpress
n	not	not{Space}	longpress
o	or	or{Space}	longpress
p	print	print(	longpress
q	queue	queue	longpress
r	return	return{Space}	longpress
s	self	self	longpress
t	try	try:{Esc}{Enter}	longpress
u	url	url	longpress
v	value	value	longpress
w	with	with :	longpress
x	xpath	xpath(	longpress
y	yield	yield	longpress
z	zip	zip	longpress
th	the	the{Space}	combination
no	node	node	combination
im	import	import{Space}	combination
fr	first	first	combination
na	name	name	combination
tr	True	True	combination
ts	this	this{Space}	combination
da	data	data	combination
fa	False	False	combination
pa	pass	pass{Enter}	combination
ty	type	type{Space}	combination
ar	array	array	combination
ta	that	that{Space}	combination
li	list	list(	combination
fi	file	file{Space}	combination
ra	raise	raise{Space}	combination
as	assert	assert{Space}	combination
ex	exception	Exception	combination
st	set	set(	combination
de	default	default	combination
ag	args	args{Space}	combination
ap	append	append(	combination
se	save	save	combination
ob	obj	obj	combination
fo	format	format(	combination
wi	will	will{Space}	combination
in	int	int(	combination
pm	param	param	combination
el	elif	elif:	combination
kw	kwargs	kwargs	combination
re	result	result	combination
al	all	all(	combination
le	line	line	combination
co	content	content	combination
rq	request	request	combination
lc	license	license	combination
te	test	test	combination
sg	string	string	combination
er	error	error	combination
us	use	use{Space}	combination
ur	user	user	combination
is	items	items(	combination
sy	sys	sys	combination
ne	none	None	combination
op	output	output	combination
ve	version	version	combination
py	python	python{Space}	combination
rs	returns	returns	combination
ca	constant	constant	combination
ix	index	index	combination
yo	you	you{Space}	combination
me	message	message	combination
ti	title	title	combination
cd	code	code{Space}	combination
an	any	any(	combination
fu	function	function	combination
rp	response	response	combination
ht	http	http	combination
va	values	values	combination
ud	used	used	combination
ms	msg	msg	combination
nu	number	number	combination
wr	write	write	combination
ou	out	out	combination
tx	text	text	combination
it	item	item	combination
pt	path	path	combination
di	directory	directory	combination
ad	add	add	combination
sh	should	should	combination
ot	other	other	combination
sa	start	start{Space}	combination
et	except	"except{Space}(Exception, ){Space}as e:{Esc}{Enter}"	combination
ig	image	image	combination
sr	str	str(	combination
si	size	size	combination
wh	which	which	combination
fn	filename	filename	combination
wn	when	when	combination
on	open	open	combination
lo	log	log	combination
ha	has	has	combination
cf	config	config	combination
cl	client	client	combination
ol	only	only	combination
oe	one	one	combination
ip	input	input	combination
mo	module	module	combination
rd	read	read	combination
cn	can	can{Space}	combination
sp	shape	shape	combination
nw	new	new	combination
js	json	json	combination
ml	model	model	combination
en	env	env	combination
mt	match	match	combination
cx	context	context	combination
ia	isinstance	isinstance	combination
mu	must	must	combination
rg	range	range(	combination
if	info	info	combination
os	options	options	combination
ma	may	may	combination
su	status	status	combination
vr	valueerror	valueerror	combination
bu	but	but{Space}	combination
fd	field	field	combination
sv	server	server	combination
ru	run	run	combination
md	mode	mode	combination
ie	instance	instance	combination
cp	copy	copy	combination
ai	api	api	combination
pr	parser	parser	combination
so	source	source	combination
ct	constant	constant	combination
up	update	update	combination
sl	split	split	combination
lg	logger	logger	combination
fs	files	files	combination
gi	given	given	combination
oj	object	object	combination
cs	cls	cls	combination
ps	params	params	combination
ed	end	end	combination
cm	command	command	combination
ae	are	are{Space}	combination
oi	optional	optional	combination
to	timeout	timeout	combination
fc	func	func	combination
t0	match	match	combination
mh	method	method	combination
sn	settings	settings	combination
he	have	have	combination
po	pO8wxW0V	pO8wxW0V	combination
tg	target	target	combination
fm	from	from{Space}{Space}import{Space}{Left 8}	combination
qu	query	query	combination
hs	headers	headers	combination
hp	help	help	combination
dg	debug	debug	combination
ut	utf	utf	combination
ev	event	event	combination
tm	time	time	combination
tn	token	token	combination
tu	tuple	tuple	combination
la	lambda	lambda x:x	combination
sw	software	software	combination
ea	each	each	combination
ug	using	using	combination
cr	Chrome	Chrome	combination
wl	while	while	combination
ch	check	check	combination
dc	dict	dict(	combination
ce	connection	connection	combination
gr	group	group	combination
cu	current	current	combination
bo	body	body	combination
ke	keys	keys	combination
fl	float	float	combination
ba	base	base	combination
or	org	org	combination
un	under	under	combination
x0	x00	x00	combination
ac	action	action	combination
ho	host	host	combination
xf	xff	xff	combination
dt	dtype	dtype	combination
ro	root	root	combination
am	america	america	combination
wa	was	was	combination
ax	axis	axis	combination
by	bytes	bytes	combination
do	document	document	combination
br	break	break	combination
af	after	after	combination
ei	either	either	combination
of	offset	offset	combination
ge	getattr	getattr	combination
at	attr	attr	combination
ri	right	right	combination
be	before	before	combination
bl	block	block	combination
em	empty	empty	combination
pu	public	public	combination
bi	bin	bin	combination
ju	just	just	combination
pl	plt	plt	combination
av	available	available	combination
tw	two	two	combination
sc	schema	schema	combination
ki	kind	kind	combination
vi	view	view	combination
wo	word	word	combination
au	author	author	combination
gn	gnu	gnu	combination
mi	min	min	combination
dj	django	django	combination
ov	over	over	combination
jo	job	job	combination
ab	about	about	combination
id	idx	idx	combination
sm	selenium	selenium	combination
gl	global	global	combination
rt	rtype	rtype	combination
we	weights	weights	combination
pi	Pi'.&@	Pi'.&@	combination
pe	permissions	permissions	combination
xm	xml	xml	combination
x1	x1b	x1b	combination
go	google	google	combination
fe	feature	feature	combination
sk	skip	skip	combination
nd	ndim	ndim	combination
pn	png	png	combination
ze	zero	zero	combination
dr	driver	driver	combination
_d	_descriptor	_descriptor	combination
ow	owner	owner	combination
xr	xrange	xrange	combination
ui	uid	uid	combination
du	dumps	dumps	combination
aw	await	await	combination
hi	history	history	combination
es	escape	escape	combination
ec	echo	echo	combination
hr	href	href	combination
c_	c_int	c_int	combination
ye	year	year	combination
sq	sqrt	sqrt	combination
eq	equal	equal	combination
gm	gmail	gmail	combination
_i	_id	_id	combination
io	ioerror	ioerror	combination
ws	wsgi	wsgi	combination
bs	bsd	bsd	combination
n_	n_samples	n_samples	combination
zo	zone	zone	combination
ic	icon	icon	combination
dn	dns	dns	combination
dw	dword	dword	combination
pd	pdf	pdf	combination
ya	yaml	yaml	combination
vo	volume	volume	combination
cw	cwd	cwd	combination
vn	vnd	vnd	combination
_n	_name	_name	combination
ep	epoch	epoch	combination
kn	know	know	combination
h2	h2o	h2o	combination
rh	rhs	rhs	combination
jp	jpg	jpg	combination
ji	jid	jid	combination
ds	dst	dst	combination
rv	rval	rval	combination
tz	tzinfo	tzinfo	combination
ul	utils	utils	combination
ci	cipher	cipher	combination
gs	gsm	gsm	combination
oa	oauth	oauth	combination
kl	klass	klass	combination
_c	_cache	_cache	combination
lu	luigi	luigi	combination
_l	_logger	_logger	combination
lh	lhs	lhs	combination
cv	cv2	cv2	combination
uw	uwlines	uwlines	combination
ga	gamma	gamma	combination
my	mypy	mypy	combination
_b	_backend	_backend	combination
cy	cython	cython	combination
fg	fgraph	fgraph	combination
eo	eof	eof	combination
ck	ckan	ckan	combination
x4	x48	x48	combination
tc	tcp	tcp	combination
hu	hub	hub	combination
gu	gui	gui	combination
x3	x32	x32	combination
_s	_state	_state	combination
iv	ivar	ivar	combination
mk	mkdir	mkdir	combination
x_	x_train	x_train	combination
rf	rfc	rfc	combination
ls	lstrip	lstrip	combination
0x	0xff	0xff	combination
gd	gdb	gdb	combination
dl	dll	dll	combination
mn	mnist	mnist	combination
nl	nltk	nltk	combination
ja	javascript	javascript	combination
ef	effect	effect	combination
x6	x66	x66	combination
gt	gtk	gtk	combination
rm	rmtree	rmtree	combination
gz	gzip	gzip	combination
je	jedi	jedi	combination
_t	_type	_type	combination
rn	rng	rng	combination
tk	tkinter	tkinter	combination
zm	zmq	zmq	combination
gp	gpuarray	gpuarray	combination
ok	okay	okay	combination
y_	y_train	y_train	combination
dy	dynamic	dynamic	combination
eg	egg	egg	combination
xo	xonsh	xonsh	combination
hy	hypothesis	hypothesis	combination
yi	yields	yields	combination
od	odoo	odoo	combination
_f	_fields	_fields	combination
zi	zipfile	zipfile	combination
oc	occurred	occurred	combination
xa	xaa	xaa	combination
pk	pkg_resources	pkg_resources	combination
hm	hmac	hmac	combination
x8	x86	x86	combination
ph	photo	photo	combination
tl	tls	tls	combination
ko	kombu	kombu	combination
_v	_version	_version	combination
_m	_message	_message	combination
db	dbname	dbname	combination
eu	europe	europe	combination
ym	ymin	ymin	combination
qt	qtile	qtile	combination
_p	_parms	_parms	combination
mp	mpl	mpl	combination
tq	tqdm	tqdm	combination
ni	nice	nice	combination
xg	xgb	xgb	combination
ft	ftp	ftp	combination
_r	_root	_root	combination
xh	xhtml	xhtml	combination
sd	sdist	sdist	combination
vc	vcs	vcs	combination
sf	sftp	sftp	combination
zh	zh_hant	zh_hant	combination
om	omd	omd	combination
wc	wcs	wcs	combination
p_	p_mi	p_mi	combination
rc	rcparams	rcparams	combination
ka	kafka	kafka	combination
ir	iris	iris	combination
yu	yutani	yutani	combination
pc	pca	pca	combination
pw	pwnlib	pwnlib	combination
x5	x50	x50	combination
xl	xlabel	xlabel	combination
wm	wmsg	wmsg	combination
tp	tweepy	tweepy	combination
xc	xc0	xc0	combination
zl	zlib	zlib	combination
_e	_errhandler	_errhandler	combination
yl	ylabel	ylabel	combination
f_	f_code	f_code	combination
u7	u79fb	u79fb	combination
jw	jwt	jwt	combination
lp	lpwstr	lpwstr	combination
u4	u4e2d	u4e2d	combination
zk	zkroot	zkroot	combination
ld	load	load	combination
x2	x20	x20	combination
nr	nrows	nrows	combination
_x	_xml_empty_tag	_xml_empty_tag	combination
df	dfa	dfa	combination
nc	ncols	ncols	combination
_a	_api	_api	combination
cg	cgi	cgi	combination
lv	lvalue	lvalue	combination
_u	_url	_url	combination
za	zappa_cli	zappa_cli	combination
b6	b64encode	b64encode	combination
_g	_get	_get	combination
2x	2xlarge	2xlarge	combination
jq	jquery	jquery	combination
dp	dpi	dpi	combination
vm	vmin	vmin	combination
np	npy_intp	npy_intp	combination
lx	lxml	lxml	combination
vp	vpc	vpc	combination
8x	8xlarge	8xlarge	combination
_h	_headers	_headers	combination
4x	4xlarge	4xlarge	combination
u9	u901a	u901a	combination
pj	pjoin	pjoin	combination
nb	nbytes	nbytes	combination
tb	tbl	tbl	combination
x7	x74	x74	combination
ub	ubuntu	ubuntu	combination
fp	fps	fps	combination
dm	dmatrix	dmatrix	combination
x9	x90	x90	combination
_k	_keys	_keys	combination
gy	gym	gym	combination
i1	i18n	i18n	combination
xb	xbf	xbf	combination
wd	wdg	wdg	combination
_q	_queue	_queue	combination
a4	a4paper	a4paper	combination
nt	nthash	nthash	combination
1o	1o1o	1o1o	combination
iz	izip	izip	combination
px	pxd	pxd	combination
vh	vhost	vhost	combination
lm	lmhash	lmhash	combination
_w	_write	_write	combination
tf	tflearn	tflearn	combination
xd	xd0	xd0	combination
ks	kshp	kshp	combination
xy	xyz	xyz	combination
qr	qrcode	qrcode	combination
vs	vstack	vstack	combination
lb	lbrynet	lbrynet	combination
xv	xval	xval	combination
kh	khtml	khtml	combination
cb	cbook	cbook	combination
ln	lng	lng	combination
il	illegal	illegal	combination
xe	xe8	xe8	combination
_j	_json	_json	combination
qo	qos	qos	combination
s3	s3_client	s3_client	combination
w1	w191	w191	combination
u5	u52d5	u52d5	combination
mr	mro	mro	combination
dh	dhcp	dhcp	combination
qn	qname	qname	combination
ey	eye	eye	combination
1s	1st	1st	combination
nv	nvim	nvim	combination
gc	gca	gca	combination
ql	qlabel	qlabel	combination
bm	bmp	bmp	combination
kg	kgriffs	kgriffs	combination
gh	ghex	ghex	combination
pf	pformat	pformat	combination
i_	i_idx	i_idx	combination
xp	xproto	xproto	combination
uv	uvloop	uvloop	combination
h5	h5py	h5py	combination
jd	jd1	jd1	combination
td	tdb_cassandra	tdb_cassandra	combination
jy	jython	jython	combination
qp	qpid	qpid	combination
az	azure	azure	combination
eb	ebx	ebx	combination
i3	i386	i386	combination
lj	ljust	ljust	combination
ly	lyrics	lyrics	combination
wf	wfile	wfile	combination
bd	bdb	bdb	combination
aj	ajax	ajax	combination
ak	aka	aka	combination
bg	bgcolor	bgcolor	combination
rl	rlock	rlock	combination
lr	lru_cache	lru_cache	combination
nf	nfft	nfft	combination
kr	kral	kral	combination
2n	2nd	2nd	combination
_o	_option	_option	combination
ah	ahead	ahead	combination
nk	nkern	nkern	combination
lf	lflags	lflags	combination
c.	cd..	cd..	combination
nm	namemain	if{Space}__name__{Space}=={Space}{Space}'__main__':{Esc}{Enter}	combination
um	firstpart	#{Space}-*-{Space}coding:{Space}utf-8{Space}-*-{Esc}{Enter}from{Space}mother{Space}import{Space}*{Esc}{Enter}{Enter}if{Space}__name__{Space}=={Space}{Space}'__main__':	combination
0	win2	#2	longpress
1	win1	#1	longpress
2	win4	#4	longpress
3	win3	#3	longpress
4	win6	#6	longpress
5	win5	#5	longpress
6	win8	#8	longpress
7	win7	#7	longpress
9	win9	#9	longpress
.	","	","	longpress
'	""""	+2	longpress
-	=	=	longpress
[	]	]	longpress
+[	+]	+]	longpress
(	)	)	longpress
F22	\	\	remap
F23	vkF3sc029	vkF3sc029	remap
F16	+	+	remap
F17	^]	^]	remap
F24	_	_	remap
!F20	<=	<=	send
!F21	>=	>=	send
F20	<	<	send
F21	>	>	send
F19	{Ctrl down}v{Ctrl up}	{Ctrl down}v{Ctrl up}	send
F18	{Ctrl down}c{Ctrl up}	{Ctrl down}c{Ctrl up}	send
^'	"""""{Left 3}"	"""""{Left 3}"	send
!(	(x for x in )	(x for x in )	send
![	[x for x in ]	[x for x in ]	send
!{	{Shift down}[{Shift up}k:v for k in {Shift down}]{Shift up}	{Shift down}[{Shift up}k:v for k in {Shift down}]{Shift up}	send
!-	{Shift down}1{Shift up}=	{Shift down}1{Shift up}=	send
^-	==	==	send
